##############################
#****************************#
#*###*#########*############*#
#*###*#########*############*#
#*###*#########*############*#
#*###*#########*############*#
#****************************#
#*######*############*######*#
#*######*############*######*#
#*######*############*######*#
#*********************######*#
#*############*######*######*#
#*############*######*######*#
#*############*######*######*#
#*############*######*######*#
#*############*######*******G#
#**************#############*#
#*######*#####*#############*#
#*######*#####*#############*#
#*######*#####*#############*#
#*######*#####*#############*#
#*######*#####*#############*#
#*######*#####***************#
#*######*###################*#
#*######*###################*#
#*######*###################*#
#****************************#
#*###########*##############*#
#************S***************#
##############################
