##############################
#S***************************#
#****************************#
#****************************#
#****************************#
#****************************#
#****************************#
#****************************#
#****************************#
#****************************#
#****************************#
#****************************#
#****************************#
#****************************#
#****************************#
#****************************#
#****************************#
#****************************#
#****************************#
#****************************#
#****************************#
#****************************#
#****************************#
#****************************#
#****************************#
#****************************#
#****************************#
#****************************#
#****************************#
##############################
