####################################################################################################
## #    ####     # #    #        #  #     ##   ##   #    ##   # ##     # #   #   #              ####
# # # ##  ##  ###     # #  # ## #  #   ###    #   # ## ##    ##     ## #    #   # # # ## #######  ##
# # #   #    #   #####  # #  # ### # #    #### ## # #    # ##   # # # #  ##### #  #  #  #       #  #
# # # # ### #  #      #  ## #   #  #  ## #      #   # # ## #  # # #   # #   ##  ## #  # # ### # ## #
# # # #   # # # # # ## #    # #   ## # #   ####  ###  ##   # # ##  ## # # #   # #  # #  #    ##    #
# # #  ##  #    # #     ### #  ###      # ##   #     #   ##  #   #   #  #  # #    #   #  ### # ### #
# #  # ###  ###  # ####   ## #    # ## # ##  #  # ###  ###  ### # ##  # # #  # ##  ##   #    #     #
# ## #  ### #  # #    # #     # # # #  #    # #  #   #     # #      #   # # #  # #  # #  # #### ####
#  #  #  #   #   # # #  ### #  #  ##  # # ###  #   #  ### ##   ####  ## #  #  #  # #   ##  # #  #  #
## ##  ##  # # ## ##  #    # ### #   ##   #   #  #  #    #   # #   #   #  #  #  ## # ##   #  # #  ##
#    #    # #   #    # # # #     # #    ##  ##  ### ####  #### # ### ##  ### # #   # #  ##  #    # #
### # ## #   ##  # ##   ##   ####  #####  #    # # #    #      #        # #  #   ###  #   #  ###   #
#     # # ##   # #   ##   ###    ##    # #  ## #     ## # # # # ### # # #   # # #   #  ##  #    ## #
# ## #     # # #  ##    # # # ##    ## #   #  #  ####   ###  #     #   ## ##  #  # # # #  #  # ##  #
# ###  # #  #   # # ## #      ### ## #  ##   #  #   # ##   ##  ###  # #   #  # # #   #  #  # #    ##
#  ## ##  #   # #     #######  #  #   #   ###  #  # #    #    #   # # # ####       #  #  #  #  ### #
##    # #  # # # ####  #     ##  # # # ##     #  #   #### ####  #    #  # #  ########  #  #  #     #
#  ###  # # #        #   ### #  #        #######  # #     #  ##  # ##  #    #      # #  # ##  #### #
## #   ##     ### # # ###  #   ## # ## # #    # #  #  # #  #    # #   #####  # # #    ##   # #   # #
#  # ##  # ###   ##   #   # ###   #   #   # #    #   # # # # # ##   ####   # # #  # #  # # #  ##   #
# ##    # #    #   ##   #     ## # ##  ##   ## #  # #      #  #   #   #  # # #  ## #  #   # #  # ###
# #  # #    ##### # # #  # # #       # # ###  # # # ## ### # #  ### #   #  ## #    # ## #   # #  # #
#  # #   # #   #  # # # #  # # ### ##  #     #    ##   # # # ###   #  ##  #   #### # #   #### # #  #
## # # # #  # ## #  # ##  #  #    #   #  ## #  ###   ##    #     # # #  #   #    # # # ##     # # ##
##  #   #  #  #   # #   ##  # ### # ### #   # ##   # #  ### #####  # ## #### ###   # #  # # ###    #
# #  # #  # #   #   ###   #     # #    #  # # #  # # # #    #   ## #  #    # #  # ##  # # ##   ## ##
#  # # # #   ##### #   ## ### ##  ####  #  #   ## #  # # ## # #    ## ## ##   #  ## #   #    #  #  #
##   # #  # #   #  # #  #    #   #   # # # # #     # #   #  #  ## # #  #    #  #     ###  ###  # # #
#  ##  ##   # #  # #  #  ###   ##  # #   # #  ## #    #### #  #  #   #  ## ## ### # #   # #   #    #
##   #   ## #  #  # # # ##  ### # #   ## #  #  #  # ##    #  # #   # ##    #   #   #  #  #  ##  ####
# ##  ## ## # # #   # #    ## #   # #  # ##  #  #  #   ##  #    # ##   #### ##  # ## # #   #  #    #
# # #   #   # #  ## #  ## #   # #  #  #    # ##  ##  ##  #  ###  #   #        #   #  #  # ###  ## ##
#    ## # # #  #  #  # #  # # # # ## # ### #   #  # #  #   #   # # #  ## # ## # # # #  # # #  ###  #
## #  # # ## #   #  #   #    #   #   #   # # #  # #  #  ## # # # ## #   #   # #  ##  # #     # #  ##
#  # #  #    # #  #  ##  # ##  # # # # #   #  #   # # #  #   # #    # #  ####  #   # # # # #   # # #
## ##  ## ##  #  ###   # #  # # #  # # # ## #  ###  #  # ### #  ### #  ##     ## # # # #  # ##   # #
#    # #    #  #  # # ## ## # #   #  # ##    # # # # #      #  #  # # #   # # #   #  #  #   # ###  #
# ##    ###  #  #   #     #   # ### ##    # #  # # #   ####  #  # # # # #  #   # #  #  #### #     ##
# # # # #  # # #  #  # ##  ###  #   # ## ## # #  #  # ##   # ##     # # ###  ##   #  #  # #  ## #  #
##   #  ##   #  # # #### # #   ## # #   #   #  #  #  #   # #   ### # ##    ##   ##  # #    #  #  # #
## #  #   ##  #  #   #    #  ###   #  # # ## # ## # #  ##  # #    #     ##  # ## # ##   ##   #  #  #
#  ## ###   ## #   ##  ##   #    # # #  # #  #  # #   # # #   ###   ###   # #    # #  #   # #  #  ##
# #     ###    ####   #   ### ###   ## #  ##   #   ###  #  # #   ###   ## #  # # #  # #####   ###  #
#  # ##   ####     # # # #   #   ## #  # # # ##  #   # #  #  # # #   # #  # ##  ###  #     # # #  ##
## # # ##     #### # #   # #   # #    #  # #  # # ##   # #  ##  #  ##   # # # #  # # # # #  #   #  #
#   #   # ## #       #####  ###  ## ##  #   # # #   ## #  #   #  #  # # # #     #    #  #  #  #  # #
# # # #  # #  # #####     # # ##   #   # # ##   # #   # #  ##  # ##  #  # # # ##  ##  # # # #  # # #
#  #  ## #  # ##      ###   #   ##   ##    #  # #  ##    #  ## #   # # #   #  #  ### #  #    # # # #
##   # # ##      ### #  ## # ##   # #   ## # # #  ## # # ##  #  # #  #  ##  ##  # #  # # ## ## #  ##
#  ##  #  #### ##   ###   #     #  #  #### #   # #   # ##   #  ## # # # # ##   #   # # #    #  ## ##
# ##  # #     #   #  #  #   # # ###  #  #   ## #  # ##    ##  #   # #   #    ##  #  #  # ## # # #  #
#    #  ### #  # ###   #####  ##    #  #  ##    # #   ####  #   ### # ## # # #  # #   ##  # # #  # #
#### # #   # #  # #  ## #   #  # # ## # #  # # #  # #     #  # #    # ##   # # #  ####  # # # # #  #
#  # #   #   ## #  #    # #  #   # #     # #  #  ##  ####  #   # # #     ## ##  #      #   ##    # #
# #   ###  #  #  #  ## #   #  #### # # ### ##  # #  #   ##   # # #  #### #     # # # # # #   # # # #
#  # #   #  ####  # #   # # #      #  #     # #  # ## #   ##  #   ##    ## ####   ## #  #  ##  ##  #
# #  # #  #   # # #   # #   # ## ## # # # ### # # #   ###   #  ## ## # #      # #     # # #   # # ##
#   #   #  ##   #  ##  # ##  #  #        #    # #   ##   ##  #  #    #   ####   #### # #    #   #  #
# # # #  #   ##  # # #   # #  #   # #####  # #  ## #   # ###  #  ##### ##   ## #    #   ####  # # ##
#  #   #  ##   # # #   #   # #  ### #     # #  #   # # #  #  #  #     ##  #  # # ## # # #   #  #   #
## ##### #  ## # # ## # # #   ##   #  ## #   #   ##  #  #  #  #  # ## #  # # # # ##   #   #  # # # #
##       # # #   #   #  #  # #   #   #  # ##  ###   ## ###  # # ## #    #  # # #   ### #####  #  # #
# ## ### #    ##  ## # ## #    ## ### #      #  # ##    # ##   #   # # # # #  #  # #      #  #  ## #
#   #   #  ##   #  # #     ###      #   ## #  # #   # ##    ##   ## # #     #  ##  # ### #  # #   ##
# #   # # #  # ### # # # ##   # ###  # # ## # #  ## #    ##  ## #     # # #  # #  # ##    # #   #  #
#  ####   ## #  #  #  # #   #  #   #   #    #  #  #  ####  #   # # ## # #  ##    #     ###  #### # #
# #    ###    # # # #   # #  #   #  # #  # #  #  # # #    # ##      # #  #   # ##  # ##    #     # #
# # # #   # ##  # #  # #  ### ## # # #####  #  # # #  # ##    # ###  #  # ##  #  #  #   ###  ###   #
# # # # #    # ##  #     #      #  #  #    ### #    # #   # #  #   #   #    #   # # # # #   ##  ## #
# ###   ### #    #  ### #  ####   # #   ##  #  ## # #  ##  ## #  ## ### # #  ##   # #  #  #   # #  #
#    # #    ####   #   # # #   ###  ## #  ##  #   #  #  ##      ##        ## # # #   #  #  ## #   ##
## #  ## # #    ## # # #   ###   ##    ##   # # #  #  #   # ### #  #### ##   # #   #  #  #  #  ### #
# # #    # # ##   #  #  ##   ###  # ##  # # #  ###  # # # # #     #    #   #    # # ##  # # ##     #
#    ###  #  # ##   # #  # #    # # # #   # ##  ## ####  #   ### ## ## ## # # # # #   #   #   ### ##
# ##   # #  #    ####  # #  ### #   #  ####   #    ##   #  ##   #   #    #  #  ## # #  ## # #   #  #
# # ##   # #  ## #    #  # #    # ## #     # ## # #   ### #   #   ##  ## # ## #   #  #    #  ### # #
##    # #  # #     # # #  #  ###   #   # # # #  ### ##    # # # ## # #   #    # ##  # ## # ##      #
#  ## #  # # #####  #   # # #   ##  #### # #   #     # # #  #  #    #  ##  ####  # #    #     ## # #
# #    # # #     # ## #   #  ##    #    #   # #  # ##  #  #  ##  ##  #  ###     #  # ## # # #   #  #
#  # # # # # # # ##   ######  # # ## ##  ##  # #  ##  # #  # #  #  # ##     ## #  # ###   # ####  ##
##  #   #  ### #  # ##    # #  #       #  ##   ##    #  # ##  #   ##   # ### # # #   #  ###     #  #
# #  ##  #    ### # # # #    #  # ####  #    #   # ##  ##   #  ##   ##  #  #   #   #  ##   ## #  # #
# ## #  #  ##  #  #   #  ###  # ##    ##  ###  # ##   #  # # #   ##   #  # # ## ### #  # #   # #  ##
#    # ## ####  #  ##   #  ## #    ##   ##    # #   #  #   #  ## #  # # ##   #    # # #  ### #  #  #
# # #    ######  # # #####  #  # ###  # #  # ## # ## #   ## #  #   # #  #  # # ##   # # #    # ## ##
# #  ###  ####  #       ###  #  #   ##  # #     #  #  ###   # #  ##    ## # #    # #  # # # #  #   #
##  #   #  ##  ### ## #  #  #  #  #   # #  ### # #   #    #    # # # ##   #   ##  #  #  #  #  #  # #
#  #  #  #    # #   #  # ##  #  #  ##   ###   #   ##  ###  # #  #  # #  ##  # #  #  #  # # # #  #  #
# #  #  # ### # # # ## #  # # # ##   # #    #   ##  # #   # # #   ##  #    ###  #  #  #  #     #  ##
# # ## #     #  # #  # # #  # #    #  #  ### # ##  ##   ##     ##   #  ## # #  #  #  #  # #####  # #
#   #  # # # # ##  # # #   #   ####  #  #    # #  #  ##### # ### ##  #   #   ## #  #  #       # #  #
# ### ##  #  # # #  #  # ##  #    # #  #  # ##   #  ##  #  #      # # ## # #     #   #  ### # #   ##
##    #  #  #    ## # # #   # ###    # # #  # # # #    #  # ## # #  # #  #  ## #  ### #   ##   ##  #
#  ##  #  # ####  # #     # #    ####  ##  #  #    # #  # #  #  #  #   #  # # ###   #   #   ## ### #
# #  #  # #     #    ######   ###    #   #   ### #   ####  #  # # # ##  #   #  # ##   ## ##  #  #  #
#  # # #   ### ##### #     # #   # #  ##  # # # # # #    #   #  # #    # ##  #     # #     # ## # ##
##    #  # # # ##   ## ###  #  # # ##   # #       # # # # ## # #   # # #   ## ### # # ## # #   ## ##
#  ##   #    #    #       #   #      ##     # # # #   #      #   #   #   #               #  ##    ##
####################################################################################################
