##############################
#****************************#
#*###*#########*############*#
#*###*#########*############*#
#*###*#########*############*#
#*###*#########*############*#
#****************************#
#*######*############*######*#
#*######*############*######*#
#*######*############*######*#
#*********************######*#
#*############*######*######*#
#*############*######*######*#
#*############*######*######*#
#*############*######*######*#
#*############*######        #
#**************#########D### #
#*######*#####*#######  G  # #
#*######*#####*#######     # #
#*######*#####*#############*#
#*######*#####*#############*#
#*######*#####*#############*#
#*######*#####***************#
#*######*###################*#
#*######*###################*#
#*######*###################*#
#****************************#
#*###########S##############*#
#****************************#
##############################
