####################################################################################################
##*#****####*****#*#****#********#**#*****##***##***#****##***#*##*****#*#***#***#**************####
#*#*#*##**##**###*****#*#**#*##*#**#***###****#***#*##*##****##*****##*#****#***#*#*#*##*#######**##
#*#*#***#****#***#####**#*#**#*###*#*#****####*##*#*#****#*##***#*#*#*#**#####*#**#**#**#*******#**#
#*#*#*#*###*#**#******#**##*#***#**#**##*#******#***#*#*##*#**#*#*#***#*#***##**##*#**#*#*###*#*##*#
#*#*#*#***#*#*#*#*#*##*#****#*#***##*#*#***####**###**##***#*#*##**##*#*#*#***#*#**#*#**#****##****#
#*#*#**##**#****#*#*****###*#**###******#*##***#*****#***##**#***#***#**#**#*#****#***#**###*#*###*#
#*#**#*###**###**#*####***##*#****#*##*#*##**#**#*###**###**###*#*##**#*#*#**#*##**##***#****#*****#
#*##*#**###*#**#*#****#*#*****#*#*#*#**#****#*#**#***#*****#*#******#***#*#*#**#*#**#*#**#*####*####
#**#**#**#***#***#*#*#**###*#**#**##**#*#*###**#***#**###*##***####**##*#**#**#**#*#***##**#*#**#**#
##*##**##**#*#*##*##**#****#*###*#***##***#***#**#**#****#***#*#***#***#**#**#**##*#*##***#**#*#**##
#****#****#*#***#****#*#*#*#*****#*#****##**##**###*####**####*#*###*##**###*#*#***#*#**##**#****#*#
###*#*##*#***##**#*##***##***####**#####**#****#*#*#****#******#********#*#**#***###**#***#**###***#
#*****#*#*##***#*#***##***###****##****#*#**##*#*****##*#*#*#*#*###*#*#*#***#*#*#***#**##**#****##*#
#*##*#*****#*#*#**##****#*#*#*##****##*#***#**#**####***###**#*****#***##*##**#**#*#*#*#**#**#*##**#
#*###**#*#**#***#*#*##*#******###*##*#**##***#**#***#*##***##**###**#*#***#**#*#*#***#**#**#*#****##
#**##*##**#***#*#*****#######**#**#***#***###**#**#*#****#****#***#*#*#*####*******#**#**#**#**###*#
##****#*#**#*#*#*####**#*****##**#*#*#*##*****#**#***####*####**#****#**#*#**########**#**#**#*****#
#**###**#*#*#********#***###*#**#********#######**#*#*****#**##**#*##**#****#******#*#**#*##**####*#
##*#***##*****###*#*#*###**#***##*#*##*#*#****#*#**#**#*#**#****#*#***#####**#*#*#****##***#*#***#*#
#**#*##**#*###***##***#***#*###***#***#***#*#****#***#*#*#*#*#*##***####***#*#*#**#*#**#*#*#**##***#
#*##****#*#****#***##***#*****##*#*##**##***##*#**#*#******#**#***#***#**#*#*#**##*#**#***#*#**#*###
#*#**#*#****#####*#*#*#**#*#*#*******#*#*###**#*#*#*##*###*#*#**###*#***#**##*#****#*##*#***#*#**#*#
#**#*#***#*#***#**#*#*#*#**#*#*###*##**#*****#****##***#*#*#*###***#**##**#***####*#*#***####*#*#**#
##*#*#*#*#**#*##*#**#*##**#**#****#***#**##*#**###***##****#*****#*#*#**#***#****#*#*#*##*****#*#*##
##**#***#**#**#***#*#***##**#*###*#*###*#***#*##***#*#**###*#####**#*##*####*###***#*#**#*#*###****#
#*#**#*#**#*#***#***###***#*****#*#****#**#*#*#**#*#*#*#****#***##*#**#****#*#**#*##**#*#*##***##*##
#**#*#*#*#***#####*#***##*###*##**####**#**#***##*#**#*#*##*#*#****##*##*##***#**##*#***#****#**#**#
##***#*#**#*#***#**#*#**#****#***#***#*#*#*#*#*****#*#***#**#**##*#*#**#****#**#*****###**###**#*#*#
#**##**##***#*#**#*#**#**###***##**#*#***#*#**##*#****####*#**#**#***#**##*##*###*#*#***#*#***#****#
##***#***##*#**#**#*#*#*##**###*#*#***##*#**#**#**#*##****#**#*#***#*##****#***#***#**#**#**##**####
#*##**##*##*#*#*#***#*#****##*#***#*#**#*##**#**#**#***##**#****#*##***####*##**#*##*#*#***#**#****#
#*#*#***#***#*#**##*#**##*#***#*#**#**#****#*##**##**##**#**###**#***#********#***#**#**#*###**##*##
#****##*#*#*#**#**#**#*#**#*#*#*#*##*#*###*#***#**#*#**#***#***#*#*#**##*#*##*#*#*#*#**#*#*#**###**#
##*#**#*#*##*#***#**#***#****#***#***#***#*#*#**#*#**#**##*#*#*#*##*#***#***#*#**##**#*#*****#*#**##
#**#*#**#****#*#**#**##**#*##**#*#*#*#*#***#**#***#*#*#**#***#*#****#*#**####**#***#*#*#*#*#***#*#*#
##*##**##*##**#**###***#*#**#*#*#**#*#*#*##*#**###**#**#*###*#**###*#**##*****##*#*#*#*#**#*##***#*#
#****#*#****#**#**#*#*##*##*#*#***#**#*##****#*#*#*#*#******#**#**#*#*#***#*#*#***#**#**#***#*###**#
#*##****###**#**#***#*****#***#*###*##****#*#**#*#*#***####**#**#*#*#*#*#**#***#*#**#**####*#*****##
#*#*#*#*#**#*#*#**#**#*##**###**#***#*##*##*#*#**#**#*##***#*##*****#*#*###**##***#**#**#*#**##*#**#
##***#**##***#**#*#*####*#*#***##*#*#***#***#**#**#**#***#*#***###*#*##****##***##**#*#****#**#**#*#
##*#**#***##**#**#***#****#**###***#**#*#*##*#*##*#*#**##**#*#****#*****##**#*##*#*##***##***#**#**#
#**##*###***##*#***##**##***#****#*#*#**#*#**#**#*#***#*#*#***###***###***#*#****#*#**#***#*#**#**##
#*#*****###****####***#***###*###***##*#**##***#***###**#**#*#***###***##*#**#*#*#**#*#####***###**#
#**#*##***####*****#*#*#*#***#***##*#**#*#*#*##**#***#*#**#**#*#*#***#*#**#*##**###**#*****#*#*#**##
##*#*#*##*****####*#*#***#*#***#*#****#**#*#**#*#*##***#*#**##**#**##***#*#*#*#**#*#*#*#*#**#***#**#
#***#***#*##*#*******#####**###**##*##**#***#*#*#***##*#**#***#**#**#*#*#*#*****#****#**#**#**#**#*#
#*#*#*#**#*#**#*#####*****#*#*##***#***#*#*##***#*#***#*#**##**#*##**#**#*#*#*##**##**#*#*#*#**#*#*#
#**#**##*#**#*##******###***#***##***##****#**#*#**##****#**##*#***#*#*#***#**#**###*#**#****#*#*#*#
##***#*#*##******###*#**##*#*##***#*#***##*#*#*#**##*#*#*##**#**#*#**#**##**##**#*#**#*#*##*##*#**##
#**##**#**####*##***###***#*****#**#**####*#***#*#***#*##***#**##*#*#*#*#*##***#***#*#*#****#**##*##
#*##**#*#*****#***#**#**#***#*#*###**#**#***##*#**#*##****##**#***#*#***#****##**#**#**#*##*#*#*#**#
#****#**###*#**#*###***#####**##****#**#**##****#*#***####**#***###*#*##*#*#*#**#*#***##**#*#*#**#*#
####*#*#***#*#**#*#**##*#***#**#*#*##*#*#**#*#*#**#*#*****#**#*#****#*##***#*#*#**####**#*#*#*#*#**#
#**#*#***#***##*#**#****#*#**#***#*#*****#*#**#**##**####**#***#*#*#*****##*##**#******#***##****#*#
#*#***###**#**#**#**##*#***#**####*#*#*###*##**#*#**#***##***#*#*#**####*#*****#*#*#*#*#*#***#*#*#*#
#**#*#***#**####**#*#***#*#*#******#**#*****#*#**#*##*#***##**#***##****##*####***##*#**#**##**##**#
#*#**#*#**#***#*#*#***#*#***#*##*##*#*#*#*###*#*#*#***###***#**##*##*#*#******#*#*****#*#*#***#*#*##
#***#***#**##***#**##**#*##**#**#********#****#*#***##***##**#**#****#***####***####*#*#****#***#**#
#*#*#*#**#***##**#*#*#***#*#**#***#*#####**#*#**##*#***#*###**#**#####*##***##*#****#***####**#*#*##
#**#***#**##***#*#*#***#***#*#**###*#*****#*#**#***#*#*#**#**#**#*****##**#**#*#*##*#*#*#***#**#***#
##*#####*#**##*#*#*##*#*#*#***##***#**##*#***#***##**#**#**#**#**#*##*#**#*#*#*#*##***#***#**#*#*#*#
##*******#*#*#***#***#**#**#*#***#***#**#*##**###***##*###**#*#*##*#****#**#*#*#***###*#####**#**#*#
#*##*###*#****##**##*#*##*#****##*###*#******#**#*##****#*##***#***#*#*#*#*#**#**#*#******#**#**##*#
#***#***#**##***#**#*#*****###******#***##*#**#*#***#*##****##***##*#*#*****#**##**#*###*#**#*#***##
#*#***#*#*#**#*###*#*#*#*##***#*###**#*#*##*#*#**##*#****##**##*#*****#*#*#**#*#**#*##****#*#***#**#
#**####***##*#**#**#**#*#***#**#***#***#****#**#**#**####**#***#*#*##*#*#**##****#*****###**####*#*#
#*#****###****#*#*#*#***#*#**#***#**#*#**#*#**#**#*#*#****#*##******#*#**#***#*##**#*##****#*****#*#
#*#*#*#***#*##**#*#**#*#**###*##*#*#*#####**#**#*#*#**#*##****#*###**#**#*##**#**#**#***###**###***#
#*#*#*#*#****#*##**#*****#******#**#**#****###*#****#*#***#*#**#***#***#****#***#*#*#*#*#***##**##*#
#*###***###*#****#**###*#**####***#*#***##**#**##*#*#**##**##*#**##*###*#*#**##***#*#**#**#***#*#**#
#****#*#****####***#***#*#*#***###**##*#**##**#***#**#**##******##********##*#*#*#***#**#**##*#***##
##*#**##*#*#****##*#*#*#***###***##****##***#*#*#**#**#***#*###*#**####*##***#*#***#**#**#**#**###*#
#*#*#****#*#*##***#**#**##***###**#*##**#*#*#**###**#*#*#*#*#*****#****#***#****#*#*##**#*#*##*****#
#****###**#**#*##***#*#**#*#****#*#*#*#***#*##**##*####**#***###*##*##*##*#*#*#*#*#***#***#***###*##
#*##***#*#**#****####**#*#**###*#***#**####***#****##***#**##***#***#****#**#**##*#*#**##*#*#***#**#
#*#*##***#*#**##*#****#**#*#****#*##*#*****#*##*#*#***###*#***#***##**##*#*##*#***#**#****#**###*#*#
##****#*#**#*#*****#*#*#**#**###***#***#*#*#*#**###*##****#*#*#*##*#*#***#****#*##**#*##*#*##******#
#**##*#**#*#*#####**#***#*#*#***##**####*#*#***#*****#*#*#**#**#****#**##**####**#*#****#*****##*#*#
#*#****#*#*#*****#*##*#***#**##****#****#***#*#**#*##**#**#**##**##**#**###*****#**#*##*#*#*#***#**#
#**#*#*#*#*#*#*#*##***######**#*#*##*##**##**#*#**##**#*#**#*#**#**#*##*****##*#**#*###***#*####**##
##**#***#**###*#**#*##****#*#**#*******#**##***##****#**#*##**#***##***#*###*#*#*#***#**###*****#**#
#*#**##**#****###*#*#*#*#****#**#*####**#****#***#*##**##***#**##***##**#**#***#***#**##***##*#**#*#
#*##*#**#**##**#**#***#**###**#*##****##**###**#*##***#**#*#*#***##***#**#*#*##*###*#**#*#***#*#**##
#****#*##*####**#**##***#**##*#****##***##****#*#***#**#***#**##*#**#*#*##***#****#*#*#**###*#**#**#
#*#*#****######**#*#*#####**#**#*###**#*#**#*##*#*##*#***##*#**#***#*#**#**#*#*##***#*#*#****#*##*##
#*#**###**####**#*******###**#**#***##**#*#*****#**#**###***#*#**##****##*#*#****#*#**#*#*#*#**#***#
##**#***#**##**###*##*#**#**#**#**#***#*#**###*#*#***#****#****#*#*#*##***#***##**#**#**#**#**#**#*#
#**#**#**#****#*#***#**#*##**#**#**##***###***#***##**###**#*#**#**#*#**##**#*#**#**#**#*#*#*#**#**#
#*#**#**#*###*#*#*#*##*#**#*#*#*##***#*#****#***##**#*#***#*#*#***##**#****###**#**#**#**#*****#**##
#*#*##*#*****#**#*#**#*#*#**#*#****#**#**###*#*##**##***##*****##***#**##*#*#**#**#**#**#*#####**#*#
#***#**#*#*#*#*##**#*#*#***#***####**#**#****#*#**#**#####*#*###*##**#***#***##*#**#**#*******#*#**#
#*###*##**#**#*#*#**#**#*##**#****#*#**#**#*##***#**##**#**#******#*#*##*#*#*****#***#**###*#*#***##
##****#**#**#****##*#*#*#***#*###****#*#*#**#*#*#*#****#**#*##*#*#**#*#**#**##*#**###*#***##***##**#
#**##**#**#*####**#*#*****#*#****####**##**#**#****#*#**#*#**#**#**#***#**#*#*###***#***#***##*###*#
#*#**#**#*#*****#****######***###****#***#***###*#***####**#**#*#*#*##**#***#**#*##***##*##**#**#**#
#**#*#*#***###*#####*#*****#*#***#*#**##**#*#*#*#*#*#****#***#**#*#****#*##**#*****#*#*****#*##*#*##
##****#**#*#*#*##***##*###**#**#*#*##***#*#*******#*#*#*#*##*#*#***#*#*#***##*###*#*#*##*#*#***##*##
#**##***#****#****#*******#***#******##*****#*#*#*#***#******#***#***#***#***************#**##****##
####################################################################################################
