##############################
#****************************#
#****************************#
#****************************#
#****************************#
#****S***********************#
#****************************#
#****************************#
#****************************#
#****************************#
#****************************#
#****************************#
#****************************#
#****************************#
#****************************#
#****************************#
#****************************#
#****************************#
#****************************#
#****************************#
#****************************#
#****************************#
#****************************#
#****************************#
#****************************#
#****************************#
#****************************#
#****************************#
#****************************#
##############################
