##############################
#****************************#
#****************************#
#****************************#
#****************************#
#****************************#
#****************************#
#****************************#
#****************************#
#****************************#
#****************************#
#****************************#
#****************************#
#****************************#
#****************************#
#****************************#
#****************************#
#****************************#
#****************************#
#****************************#
#****************************#
#****************************#
#****************************#
#****************************#
#****************************#
#****************************#
#****************************#
#****************************#
#****************************#
###############################
